WWWWWWW
WRRRRwW
WwRRRRW
WRwRRRW
WRwwRRW
WRRRRwW
WWWWWWW
