WWWWWWW
WRRRRRW
WRRRRwW
WRRRwRW
WRRRRRW
WwwRRwW
WWWWWWW
