WWWWWWW
WRRRRWW
WWRRRRW
WRwRRRW
WRwwRRW
WRRRRwW
WWWWWWW
