WWWWWWW
WRRRwRW
WRRRRRW
WwwRRRW
WRWRRRW
WRRRRRW
WWWWWWW
