WWWWWWW
WRRRwRW
WRRwRRW
WRRwRRW
WwwwwRW
WRwwwRW
WWWWWWW
