WWWWWWWWWWW
WRRWRRRwRRW
WRRRRRRwRRW
WRRRRRRRwRW
WRRRRRwRwwW
WRWRRRwwRRW
WRRRRwwwRwW
WRRRwwRRRRW
WRRRRRRRRRW
WRWRRRRRRRW
WWWWWWWWWWW
