WWWWWWWWWWW
WwRwWRRRRRW
WRRRRWRRRRW
WRRRRRRRRRW
WRRRwRRRwRW
WRRRRRRRRRW
WRRwRRRRRRW
WwwRwwRRRRW
WwRRRRwRRRW
WwRRwRRRwwW
WWWWWWWWWWW
