WWWWWWW
WRRRRRW
WRRRRwW
WRRwRRW
WRRRwwW
WRRRRwW
WWWWWWW
