WWWWWWW
WRWRRWW
WRRRRRW
WRwRRRW
WRRRRRW
WRRRwRW
WWWWWWW
