WWWWWWWWWWW
WRRRwRRRwwW
WwwRRRRRRRW
WRRRRRRRwRW
WRRRRwRRRwW
WRwRRRRRRRW
WwRRRRRwRRW
WRRRRRRRRRW
WwRRRRRwRRW
WRwRRRRRwwW
WWWWWWWWWWW
