WWWWWWW
WRRRWRW
WRRRRRW
WwWRRRW
WRWRRRW
WRRRRRW
WWWWWWW
