WWWWWWW
WRRRWRW
WRRRRRW
WWWRRRW
WRWRRRW
WRRRRRW
WWWWWWW
