WWWWWWW
WRRRwRW
WRRWRRW
WRRwRRW
WwwwwRW
WRwwwRW
WWWWWWW
