WWWWWWWWWWW
WRRRwRRRRRW
WRwwRRRRWRW
WRRRRRRRRRW
WRRwRRRRRRW
WRRwRRRRRRW
WRRRRRRRRRW
WRRRRRRRWwW
WRRRWRRRRWW
WWRWWRRRRRW
WWWWWWWWWWW
