WWWWWWW
WRRRwRW
WRRwRRW
WwwwRwW
WRRRwRW
WRRwRRW
WWWWWWW
