WWWWWWW
WRRRRRW
WRRRRRW
WRRRRRW
WRRwRRW
WRRRRwW
WWWWWWW
