WWWWWWW
WRRRWRW
WRRRWRW
WRRRwRW
WRRRRwW
WRRRwRW
WWWWWWW
