WWWWWWW
WRRRwRW
WRRRwRW
WRRRRRW
WwRRRRW
WRwRRRW
WWWWWWW
