RRRRRERRRRR
RRRRRRBRRRR
RRRRRRRRRRR
RRRRRRRRRRR
RRRRRRRBRRR
RRRRRRRRRRR
RRRRRRRRRRR
RBRRFRRXRRR
RRRRRRRRRRR
RRRRRRFRRRR
RRRRRRRRRRR
