WWWWWWW
WRWRWRW
WRRRRRW
WRRRRRW
WwRRRRW
WwwRRwW
WWWWWWW
