WWWWWWWWWWW
WWWWRRRRWRW
WRRRRRRRRRW
WRRRRRRWRRW
WRRRRRwRRRW
WRRwRRRRRWW
WRRRRRRRRWW
WwwRwwRRWRW
WRRRRwRRRRW
WRRRRwRRRRW
WWWWWWWWWWW
