WWWWWWW
WRRRWRW
WRRRWRW
WRRWRwW
WRWRRRW
WRRRRRW
WWWWWWW
