WWWWWWWWWWW
WRRRRRRRRWW
WRWWRRRRRRW
WRRRWWRRRRW
WRRRRWRRRwW
WRRRRRRwRRW
WRRRRRRRRRW
WRRRwRRRRRW
WRRRRwRRRRW
WRwRRRwRRRW
WWWWWWWWWWW
