WWWWWWW
WRRRRRW
WRRWWRW
WWRRRRW
WRRRRRW
WWRRRRW
WWWWWWW
