WWWWWWW
WRRRRRW
WRRRWWW
WRRRRRW
WRwRRRW
WwRRwRW
WWWWWWW
